1111111111111
1EP0000000C01
1111111111101
1000C00C00101
1011111110101
1C1000CS10101
1010111E1C101
101C111110101
101000C0001C1
1011111111101
1C00000C00001
1111111111111