111111111
10001B0C1
1000BCBE1
10P0B0001
1S000B0S1
111111111