1111111
1000P01
1C111B1
1000001
1S1B101
1000B01
1B101C1
10E0B11
1111111