11111111111111
1CS100000000C1
1000B001110101
1011010SC10101
10101BBB010101
10000BPB000101
1010BBBB01C001
100B0000001101
11010111111101
1C01000E1C0001
11111111111111