111111111111
1P0000000001
10000001B101
1C00B01C0B01
100BC0BC0B01
1000B01C0B01
10000E01S1C1
111111111111