111111111
100C1B0C1
100SBB0E1
10PB00001
100BB0S11
111111111