111111111
100C0C011
10P001BE1
10001S011
111111111