11111
1CSC1
1E1P1
10SC1
1C101
101E1
1CCC1
11111