11111
1CSC1
1E1P1
10SC1
10101
1B1E1
1CCC1
11111