111111111111
10S1000000C1
1000011110C1
1P011EE00001
1000S11110C1
1P011EE0S001
1000011110C1
1P011EE000S1
111111111111