1111111111111111111111111
1P000000000SC000000000001
1010000101111010000111001
1010EE0101000010000100101
101000010100001000010S101
1011111101110010000111001
1010000101000010000100001
1010EE0101000010000100C01
1010000101111011110100001
10000000000000CCCC0000001
1111111111111111111111111